{
  "levels": [
    {
      "id": 1,
      "frames_per_move": 60,
      "pixels_per_move": 9,
      "boxes": [
        "******      *",
        "*           *",
        "*           *",
        "*       *** *",
        "*           *",
        "*           *",
        "*   ***     *",
        "*           *",
        "*           *",
        "***         *",
        "*           *",
        "*           *",
        "*  ***      *",
        "*           *",
        "*           *",
        "*       *** *",
        "*           *",
        "*           *",
        "*     **    *",
        "*           *",
        "***         *",
        "*           *",
        "*           *",
        "*   ***     *",
        "*           *",
        "*           *",
        "*       *****",
        "*           *",
        "*   ***     *",
        "*           *",
        "*           *",
        "******      *",
        "*           *",
        "*       *****",
        "*           *",
        "*           *",
        "*************"
      ]
    }
  ]
}
