{
  "levels": [
    {
      "id": 1,
      "keywords": [
        "apa",
        "bepa",
        "cepa",
        "depa",
        "eepa",
        "fepa",
        "gepa",
        "hepa"
      ],
      "boxes": [
        "*           *",
        "*           *",
        "*           *",
        "* f         *",
        "******      *",
        "*           *",
        "*           *",
        "*       *** *",
        "*    k      *",
        "*           *",
        "*   ***     *",
        "*           *",
        "*           *",
        "***  k      *",
        "*           *",
        "*           *",
        "*  ***      *",
        "*         k *",
        "*           *",
        "*       *** *",
        "*           *",
        "*           *",
        "*k    **    *",
        "*           *",
        "***         *",
        "*    k      *",
        "*           *",
        "*   ***     *",
        "*           *",
        "*           *",
        "*       *****",
        "*           *",
        "*   ***     *",
        "*           *",
        "*         k *",
        "******      *",
        "*           *",
        "*       *****",
        "*  k        *",
        "*           *",
        "*************"
      ]
    }
  ]
}
