{
  "levels": [
    {
      "id": 2,
      "keywords": [
        "c++",
        "python",
        "bash",
        "linux"
      ],
      "boxes": [
        "*           *",
        "*         f *",
        "*       *****",
        "*     k     *",
        "*   ***     *",
        "*           *",
        "* k         *",
        "******      *",
        "*         k *",
        "*       *****",
        "*           *",
        "*k          *",
        "*************"
      ]
    },
    {
      "id": 1,
      "keywords": [
        "apa",
        "bepa",
        "cepa",
        "depa",
        "eepa",
        "fepa",
        "gepa",
        "hepa"
      ],
      "boxes": [
        "  f          ",
        "******      *",
        "*           *",
        "*           *",
        "*       *** *",
        "*           *",
        "*     k     *",
        "*   ***     *",
        "*           *",
        "*           *",
        "***         *",
        "*           *",
        "*  k        *",
        "*  ***      *",
        "*           *",
        "*        k  *",
        "*       *** *",
        "*           *",
        "*           *",
        "*     **    *",
        "* k         *",
        "***         *",
        "*           *",
        "*   k       *",
        "*   ***     *",
        "*           *",
        "*           *",
        "*       *****",
        "*           *",
        "*   ***     *",
        "*           *",
        "* k         *",
        "******      *",
        "*         k *",
        "*       *****",
        "*           *",
        "*k          *",
        "*************"
      ]
    }
  ]
}
